**********
**       *
** ***** *
**s*****f*
**********